
BR : 巴西
IN : 印度
CI : 象牙海岸
VN : 越南
BO : 玻利维亚
KR : 韩国
AT : 奥地利
RO : 罗马尼亚
ID : 印度尼西亚
IR : 伊朗
TH : 泰国
CN : 中国
RS : 塞尔维亚
TW : 台湾
MF : 法属圣马丁
LT : 立陶宛
MY : 马来西亚
EG : 埃及
RU : 俄罗斯联邦
JO : 约旦
MA : 摩洛哥
QA : 卡塔尔
CO : 哥伦比亚
KZ : 哈萨克斯坦
DE : 德国
GB : 英国
PK : 巴基斯坦
TR : 土耳其
UY : 乌拉圭
HU : 匈牙利
IE : 爱尔兰
PR : 波多黎各
UA : 乌克兰
IT : 意大利
FR : 法国
US : 美国
JP : 日本
MX : 墨西哥
PL : 波兰
AM : 亚美尼亚
ES : 西班牙
BD : 孟加拉国
NZ : 新西兰
AL : 阿尔巴尼亚
SG : 新加坡
CY : 塞浦路斯
ZA : 南非
AR : 阿根廷
BG : 保加利亚
IL : 以色列
VE : 委内瑞拉
TN : 突尼斯
CL : 智利
AE : 阿联酋
DO : 多米尼加
CW : 库拉索
TJ : 塔吉克斯坦
PY : 巴拉圭
WS : 萨摩亚
OM : 阿曼
AU : 澳大利亚
CH : 瑞士
GR : 希腊
PE : 秘鲁
BA : 波黑
DZ : 阿尔及利亚
SI : 斯洛文尼亚
NL : 荷兰
HN : 洪都拉斯
SA : 沙特阿拉伯
LB : 黎巴嫩
LK : 斯里兰卡
BH : 巴林
MK : 前南马其顿
KW : 科威特
PH : 菲律宾
TT : 特立尼达和多巴哥
MN : 蒙古
PT : 葡萄牙
UZ : 乌兹别克斯坦
PA : 巴拿马
HR : 克罗地亚
SR : 苏里南
FI : 芬兰
KH : 柬埔寨
DM : 多米尼克
SV : 萨尔瓦多
MD : 摩尔多瓦
LI : 列支敦士登
HK : 香港
SK : 斯洛伐克
BS : 巴哈马
CR : 哥斯达黎加
JE : 泽西岛
AZ : 阿塞拜疆
SN : 塞内加尔
XK : 科索沃
IQ : 伊拉克
GE : 格鲁吉亚
CA : 加拿大
BN : 文莱
LC : 圣卢西亚
BY : 白俄罗斯
MT : 马耳他
MO : 中国澳门
TZ : 坦桑尼亚
MU : 毛里求斯
GP : 瓜德罗普
BE : 比利时
NP : 尼泊尔
AO : 安哥拉
YE : 也门
KG : 吉尔吉斯斯坦
EC : 厄瓜多尔
SE : 瑞典
ME : 黑山
LV : 拉脱维亚
MQ : 马提尼克
RE : 留尼汪岛
SD : 苏丹
GY : 圭亚那
CM : 喀麦隆
VI : 美属维尔京群岛
NG : 尼日利亚
AD : 安道尔
LA : 老挝
CZ : 捷克
JM : 牙买加
KE : 肯尼亚
IM : 马恩岛
GT : 危地马拉
PS : 巴勒斯坦
GA : 加蓬
DK : 丹麦
NI : 尼加拉瓜
GU : 关岛
MV : 马尔代夫
KN : 圣基茨和尼维斯
SC : 塞舌尔
CV : 佛得角
NC : 新喀里多尼亚
YT : 马约特
BB : 巴巴多斯
SL : 塞拉利昂
FJ : 斐济
BW : 博茨瓦纳
BZ : 伯利兹
AW : 阿鲁巴
TG : 多哥
EE : 爱沙尼亚
GG : 根西岛
MR : 毛里塔尼亚
GF : 法属圭亚那
MZ : 莫桑比克
NO : 挪威
AF : 阿富汗
MP : 北马里亚纳群岛
GN : 几内亚
LU : 卢森堡
BM : 百慕大
SY : 叙利亚
GD : 格林纳达
VG : 英属维尔京群岛
HT : 海地
KY : 开曼群岛
NA : 纳米比亚
GH : 加纳
MG : 马达加斯加
VC : 圣文森特和格林纳丁斯
LY : 利比亚
AS : 美属萨摩亚
BJ : 贝宁
UG : 乌干达
VU : 瓦努阿图
AG : 安提瓜和巴布达
TC : 特克斯和凯科斯群岛
BF : 布基纳法索
SM : 圣马力诺
NE : 尼日尔
ZW : 津巴布韦
IS : 冰岛
LS : 莱索托
PF : 法属波利尼西亚
CK : 库克群岛
ZM : 赞比亚
MS : 蒙特塞拉特岛
ST : 圣多美和普林西比
BQ : 荷兰加勒比
SX : 荷属圣马丁
TL : 东帝汶
GL : 格陵兰
WF : 瓦利斯和富图纳群岛
MW : 马拉维
GI : 直布罗陀
MM : 缅甸
SZ : 斯威士兰
BT : 不丹
ET : 埃塞俄比亚
FK : 福克兰群岛
GM : 冈比亚
GQ : 赤道几内亚
KM : 科摩罗
BI : 布隆迪
CG : 刚果共和国
RW : 卢旺达
SS : 南苏丹
CD : 刚果民主共和国
ML : 马里
MC : 摩纳哥
SO : 索马里
LR : 利比里亚
FO : 法罗群岛
PW : 帕劳
AI : 安圭拉
TO : 汤加
SB : 所罗门群岛
CU : 古巴
AX : 奥兰群岛
MH : 马绍尔群岛
GJ : 刚果布
LN : 留尼汪

USAL : 亚拉巴马
USAK : 阿拉斯加
USAZ : 亚利桑那
USAR : 阿肯色
USCA : 加利福尼亚
USCO : 科罗拉多
USCT : 康涅狄格
USDE : 特拉华
USFL : 佛罗里达
USGA : 佐治亚
USHI : 夏威夷
USID : 爱达荷
USIL : 伊利诺伊
USIN : 印第安纳
USIA : 艾奥瓦
USKS : 堪萨斯
USKY : 肯塔基
USLA : 路易斯安那
USME : 缅因
USMD : 马里兰
USMA : 马萨诸塞
USMI : 密歇根
USMN : 明尼苏达
USMS : 密西西比
USMO : 密苏里
USMT : 蒙大拿
USNE : 内布拉斯加
USNV : 内华达
USNH : 新罕布什尔
USNJ : 新泽西
USNM : 新墨西哥
USNY : 纽约
USNC : 北卡罗来纳
USND : 北达科他
USOH : 俄亥俄
USOK : 俄克拉何马
USOR : 俄勒冈
USPA : 宾夕法尼亚
USRI : 罗得岛
USSC : 南卡罗来纳
USSD : 南达科他
USTN : 田纳西
USTX : 德克萨斯
USUT : 犹他
USVT : 佛蒙特
USVA : 弗吉尼亚
USWA : 华盛顿
USWD : 华盛顿特区
USWV : 西弗吉尼亚
USWI : 威斯康星
USWY : 怀俄明